ə	@
aː	a
ɑ	aa
b	b
d	d
eː	e
ɛ	ee
ɛɪ	ei
øː	eu
f	f
ɡ	g
ɣ	gg
h	h
i	i
ɪ	ii
j	j
k	k
l	l
m	m
n	n
ŋ	nn
oː	o
ɔː	o
ɔ	oo
ʌʊ	ou
p	p
r	r
s	s
ʃ	ss
t	t
u	u
œy	ui
v	v
ʋ	w
w	w
x	x
y	y
ɵ	yy
z	z
aɪ	ei
dʒ	d+j
ʒ	d+j
eʊ	e
ɪː	e
ɲ	n+j
tʲ	t+j
uː	u
ʌ	aa
